**********
*X*XXXX*XX
**********
*XXXXX*X*X
**********
XX*X*XX*XX
**********
*XXXXXX*X*
**********
XXXXXXXXX*